{
  "men": {
    "42": 793,
    "43": 794,
    "44": 795
  },
  "women": {
    "36": 798,
    "37": 799,
    "38": 800,
    "39": 801,
    "40": 802
  },
  "kids": {
    "28": 230,
    "29": 231,
    "30": 232,
    "31": 233,
    "32": 234,
    "33": 235
  }
}